TST = "countries/Test.txt"
TOT = "countries/Totaristan.txt"
PET = "countries/Peterandia.txt"
AAA = "countries/Alentejo_and_Algarve.txt"
COR = "countries/Arquipelago_da_Coruja.txt"
OFI = "countries/Ofiussia.txt"
HER = "countries/Herya.txt"
BLA = "countries/Blasiu.txt"
DEL = "countries/Delegacia.txt"
LUS = "countries/Lusitanialand.txt"
MED = "countries/Medar.txt"
PAT = "countries/Patraolandia.txt"
DAL = "countries/Lusofonia.txt"
PEA = "countries/Peacful.txt"
PIO = "countries/Portugalio.txt"
CND = "countries/Condado.txt"
UNI = "countries/United.txt"
ALN = "countries/Albania.txt"
APA = "countries/Apartamento.txt"
GRI = "countries/Grijo.txt"
MUS = "countries/Musheena.txt"
GLO = "countries/Gloristan.txt"
CAX = "countries/Caxina.txt"
JRG = "countries/Jorjolandia.txt"
WOR = "countries/Workers.txt"
NRT = "countries/Northportugal.txt"
NHO = "countries/Northportugalinho.txt"
KIN = "countries/Kingdom.txt"
COM = "countries/Comonia.txt"
NOO = "countries/Nookie.txt"